{
  "tileset": "F:\\2D Pixel Dungeon Asset Pack v2.0\\2D Pixel Dungeon Asset Pack\\character and tileset\\Dungeon_Tileset.png",
  "grid": [
    [[6,0],[6,0],[6,0],[6,0],[6,0],[6,0],[6,0],[6,0],[6,0],[6,0],[6,0],[6,0]],
    [[6,0],[6,0],[2,6],[6,0],[6,0],[6,0],[6,0],[6,0],[6,0],[6,0],[6,0],[6,0]],
    [[0,7],[1,7],[6,0],[6,0],[6,0],[6,0],[6,0],[6,0],[6,0],[6,0],[6,0],[6,0]],
    [[0,7],[1,7],[6,0],[6,0],[6,0],[6,0],[6,0],[6,0],[6,0],[2,7],[2,7],[3,7]],
    [[0,7],[1,7],[2,7],[2,7],[2,7],[2,7],[6,3],[6,3],[6,3],[2,7],[2,7],[3,7]],
    [[0,7],[1,7],[2,7],[2,7],[2,7],[6,3],[2,7],[6,3],[6,3],[6,3],[6,3],[3,7]],
    [[0,7],[1,7],[2,7],[2,7],[6,3],[6,3],[6,3],[2,7],[6,3],[6,3],[2,7],[3,7]],
    [[0,7],[6,3],[2,7],[6,3],[2,7],[6,3],[2,7],[6,3],[6,3],[6,3],[2,7],[3,7]],
    [[0,7],[6,3],[2,7],[6,3],[6,3],[2,7],[6,3],[6,3],[6,3],[2,7],[2,7],[3,7]],
    [[0,7],[6,3],[6,3],[6,3],[6,3],[6,3],[6,3],[2,7],[2,7],[2,7],[2,7],[3,7]],
    [[0,7],[1,7],[6,3],[6,3],[6,3],[6,3],[2,7],[2,7],[2,7],[2,7],[2,7],[3,7]],
    [[0,8],[1,8],[2,8],[2,8],[2,8],[2,8],[2,8],[2,8],[2,8],[2,8],[2,8],[3,8]]
  ]
}
