{
  "tileset": "assets/tiles.png",
  "grid": [
    [[12,5],[13,5],[4,3],[4,3],[5,3],[4,3],[4,3],[4,3],[15,4],[14,5],[15,5],[3,1]],
    [[12,6],[13,6],[0,6],[0,6],[2,6],[0,6],[2,6],[0,6],[2,6],[14,6],[15,6],[4,5]],
    [[0,7],[1,7],[2,7],[2,7],[2,7],[2,7],[2,7],[2,7],[2,6],[2,7],[2,6],[3,7]],
    [[0,7],[1,7],[2,7],[2,7],[2,7],[2,7],[2,7],[2,7],[2,7],[2,7],[2,7],[3,7]],
    [[0,7],[1,7],[2,7],[2,7],[2,7],[0,2],[2,7],[2,7],[2,7],[2,7],[13,0],[3,7]],
    [[0,7],[1,7],[2,7],[2,7],[2,7],[0,2],[0,2],[2,7],[2,7],[2,7],[7,3],[3,7]],
    [[0,7],[1,7],[0,2],[0,2],[0,2],[0,2],[0,2],[0,2],[2,7],[2,7],[2,7],[3,7]],
    [[0,7],[1,7],[2,7],[2,7],[0,2],[0,2],[0,2],[0,2],[0,2],[0,2],[2,7],[3,7]],
    [[0,7],[1,7],[2,7],[2,7],[0,2],[0,2],[0,2],[0,2],[0,2],[0,2],[2,7],[3,7]],
    [[0,7],[1,7],[2,7],[2,7],[2,7],[0,2],[0,2],[2,7],[2,7],[2,7],[2,7],[3,7]],
    [[0,7],[1,7],[2,7],[2,7],[2,7],[2,7],[2,7],[2,7],[2,7],[2,7],[2,7],[3,7]],
    [[0,8],[1,8],[2,8],[2,8],[2,8],[2,8],[2,8],[2,8],[2,8],[2,8],[2,8],[3,8]]
  ]
}
