{
  "tileset": "F:\\2D Pixel Dungeon Asset Pack v2.0\\2D Pixel Dungeon Asset Pack\\character and tileset\\Dungeon_Tileset.png",
  "grid": [
    [[7,1],[7,1],[7,1],[7,1],[7,1],[7,1],[7,1],[7,1],[7,1],[7,1],[7,1],[7,1]],
    [[6,0],[6,0],[2,6],[6,0],[6,0],[7,1],[7,1],[7,1],[6,0],[6,0],[6,0],[6,0]],
    [[0,7],[1,7],[6,0],[6,0],[6,0],[6,0],[6,0],[6,0],[7,1],[6,0],[6,0],[6,0]],
    [[0,7],[1,7],[6,0],[6,0],[6,0],[6,0],[6,0],[6,0],[6,0],[2,7],[2,7],[3,7]],
    [[0,7],[1,7],[2,7],[7,1],[7,1],[7,1],[7,1],[7,1],[7,1],[7,1],[7,1],[7,1]],
    [[0,7],[1,7],[2,7],[7,1],[7,1],[7,1],[7,1],[7,1],[7,1],[7,1],[7,1],[7,1]],
    [[7,1],[7,1],[7,1],[7,1],[7,1],[7,1],[7,1],[7,1],[7,1],[7,1],[7,1],[7,1]],
    [[7,1],[7,1],[7,1],[7,1],[7,1],[7,1],[7,1],[7,1],[7,1],[7,1],[2,7],[3,7]],
    [[7,1],[7,1],[7,1],[7,1],[7,1],[7,1],[7,1],[7,1],[7,1],[7,1],[2,7],[3,7]],
    [[7,1],[7,1],[7,1],[7,1],[7,1],[7,1],[7,1],[7,1],[7,1],[7,1],[7,1],[7,1]],
    [[7,1],[7,1],[7,1],[7,1],[7,1],[7,1],[7,1],[7,1],[7,1],[7,1],[7,1],[7,1]],
    [[7,1],[7,1],[7,1],[7,1],[7,1],[7,1],[7,1],[7,1],[7,1],[7,1],[7,1],[7,1]]
  ]
}
